"filename", "language", "JavaScript JSX", "CSS", "JavaScript", "JSON", "comment", "blank", "total"
"c:\Users\bazc\Desktop\coding\frontend-mentors\invoice-app\frontend\src\App.jsx", "JavaScript JSX", 86, 0, 0, 0, 3, 15, 104
"c:\Users\bazc\Desktop\coding\frontend-mentors\invoice-app\frontend\src\components\CancelEditFormModal.jsx", "JavaScript JSX", 28, 0, 0, 0, 0, 10, 38
"c:\Users\bazc\Desktop\coding\frontend-mentors\invoice-app\frontend\src\components\ConfirmActionModalTemplate.jsx", "JavaScript JSX", 32, 0, 0, 0, 9, 5, 46
"c:\Users\bazc\Desktop\coding\frontend-mentors\invoice-app\frontend\src\components\ConfirmDeleteModal.jsx", "JavaScript JSX", 31, 0, 0, 0, 1, 10, 42
"c:\Users\bazc\Desktop\coding\frontend-mentors\invoice-app\frontend\src\components\Container.jsx", "JavaScript JSX", 4, 0, 0, 0, 0, 1, 5
"c:\Users\bazc\Desktop\coding\frontend-mentors\invoice-app\frontend\src\components\FilterItemCheckbox.jsx", "JavaScript JSX", 33, 0, 0, 0, 0, 7, 40
"c:\Users\bazc\Desktop\coding\frontend-mentors\invoice-app\frontend\src\components\Filters.jsx", "JavaScript JSX", 18, 0, 0, 0, 1, 7, 26
"c:\Users\bazc\Desktop\coding\frontend-mentors\invoice-app\frontend\src\components\FormSectionButton.jsx", "JavaScript JSX", 21, 0, 0, 0, 2, 3, 26
"c:\Users\bazc\Desktop\coding\frontend-mentors\invoice-app\frontend\src\components\GoBackLink.jsx", "JavaScript JSX", 11, 0, 0, 0, 0, 3, 14
"c:\Users\bazc\Desktop\coding\frontend-mentors\invoice-app\frontend\src\components\InvoiceFormItem.jsx", "JavaScript JSX", 115, 0, 0, 0, 6, 12, 133
"c:\Users\bazc\Desktop\coding\frontend-mentors\invoice-app\frontend\src\components\InvoicesControlPanel.jsx", "JavaScript JSX", 12, 0, 0, 0, 1, 5, 18
"c:\Users\bazc\Desktop\coding\frontend-mentors\invoice-app\frontend\src\components\LoadingAnimation.jsx", "JavaScript JSX", 15, 0, 0, 0, 0, 1, 16
"c:\Users\bazc\Desktop\coding\frontend-mentors\invoice-app\frontend\src\components\MobileNav.jsx", "JavaScript JSX", 63, 0, 0, 0, 6, 11, 80
"c:\Users\bazc\Desktop\coding\frontend-mentors\invoice-app\frontend\src\components\NavLinkItem.jsx", "JavaScript JSX", 4, 0, 0, 0, 0, 1, 5
"c:\Users\bazc\Desktop\coding\frontend-mentors\invoice-app\frontend\src\components\Navbar.jsx", "JavaScript JSX", 121, 0, 0, 0, 10, 23, 154
"c:\Users\bazc\Desktop\coding\frontend-mentors\invoice-app\frontend\src\components\NoInvoices.jsx", "JavaScript JSX", 26, 0, 0, 0, 0, 6, 32
"c:\Users\bazc\Desktop\coding\frontend-mentors\invoice-app\frontend\src\components\Overview.jsx", "JavaScript JSX", 45, 0, 0, 0, 0, 6, 51
"c:\Users\bazc\Desktop\coding\frontend-mentors\invoice-app\frontend\src\components\RandomLogo.jsx", "JavaScript JSX", 8, 0, 0, 0, 0, 2, 10
"c:\Users\bazc\Desktop\coding\frontend-mentors\invoice-app\frontend\src\components\TextInputWithValidation.jsx", "JavaScript JSX", 27, 0, 0, 0, 0, 2, 29
"c:\Users\bazc\Desktop\coding\frontend-mentors\invoice-app\frontend\src\context\AuthContext.jsx", "JavaScript JSX", 33, 0, 0, 0, 2, 9, 44
"c:\Users\bazc\Desktop\coding\frontend-mentors\invoice-app\frontend\src\context\InvoicesContext.jsx", "JavaScript JSX", 75, 0, 0, 0, 4, 6, 85
"c:\Users\bazc\Desktop\coding\frontend-mentors\invoice-app\frontend\src\context\useModalStore.jsx", "JavaScript JSX", 29, 0, 0, 0, 3, 8, 40
"c:\Users\bazc\Desktop\coding\frontend-mentors\invoice-app\frontend\src\data\data.json", "JSON", 0, 0, 0, 219, 0, 1, 220
"c:\Users\bazc\Desktop\coding\frontend-mentors\invoice-app\frontend\src\hooks\reactQueryHooks\useAddNewInvoice.jsx", "JavaScript JSX", 33, 0, 0, 0, 2, 13, 48
"c:\Users\bazc\Desktop\coding\frontend-mentors\invoice-app\frontend\src\hooks\reactQueryHooks\useAuth.jsx", "JavaScript JSX", 30, 0, 0, 0, 0, 7, 37
"c:\Users\bazc\Desktop\coding\frontend-mentors\invoice-app\frontend\src\hooks\reactQueryHooks\useDeleteInvoice.jsx", "JavaScript JSX", 37, 0, 0, 0, 14, 18, 69
"c:\Users\bazc\Desktop\coding\frontend-mentors\invoice-app\frontend\src\hooks\reactQueryHooks\useFilterInvoiceById.jsx", "JavaScript JSX", 28, 0, 0, 0, 1, 14, 43
"c:\Users\bazc\Desktop\coding\frontend-mentors\invoice-app\frontend\src\hooks\reactQueryHooks\useGetUserDetails.jsx", "JavaScript JSX", 25, 0, 0, 0, 3, 12, 40
"c:\Users\bazc\Desktop\coding\frontend-mentors\invoice-app\frontend\src\hooks\reactQueryHooks\useInvoiceId.jsx", "JavaScript JSX", 17, 0, 0, 0, 0, 9, 26
"c:\Users\bazc\Desktop\coding\frontend-mentors\invoice-app\frontend\src\hooks\reactQueryHooks\useInvoices.jsx", "JavaScript JSX", 27, 0, 0, 0, 1, 13, 41
"c:\Users\bazc\Desktop\coding\frontend-mentors\invoice-app\frontend\src\hooks\reactQueryHooks\useUpdateInvoice.jsx", "JavaScript JSX", 34, 0, 0, 0, 1, 12, 47
"c:\Users\bazc\Desktop\coding\frontend-mentors\invoice-app\frontend\src\hooks\reactQueryHooks\useUpdateInvoiceId.jsx", "JavaScript JSX", 17, 0, 0, 0, 0, 7, 24
"c:\Users\bazc\Desktop\coding\frontend-mentors\invoice-app\frontend\src\hooks\reactQueryHooks\useUpdateUser.jsx", "JavaScript JSX", 34, 0, 0, 0, 3, 11, 48
"c:\Users\bazc\Desktop\coding\frontend-mentors\invoice-app\frontend\src\hooks\useCheckForUser.jsx", "JavaScript JSX", 11, 0, 0, 0, 0, 5, 16
"c:\Users\bazc\Desktop\coding\frontend-mentors\invoice-app\frontend\src\hooks\useFormatDate.jsx", "JavaScript JSX", 27, 0, 0, 0, 0, 4, 31
"c:\Users\bazc\Desktop\coding\frontend-mentors\invoice-app\frontend\src\hooks\useLogin.jsx", "JavaScript JSX", 31, 0, 0, 0, 3, 9, 43
"c:\Users\bazc\Desktop\coding\frontend-mentors\invoice-app\frontend\src\hooks\useLogout.jsx", "JavaScript JSX", 11, 0, 0, 0, 2, 4, 17
"c:\Users\bazc\Desktop\coding\frontend-mentors\invoice-app\frontend\src\hooks\usePaymentStatusColor.jsx", "JavaScript JSX", 38, 0, 0, 0, 1, 7, 46
"c:\Users\bazc\Desktop\coding\frontend-mentors\invoice-app\frontend\src\hooks\useSignup.jsx", "JavaScript JSX", 32, 0, 0, 0, 3, 11, 46
"c:\Users\bazc\Desktop\coding\frontend-mentors\invoice-app\frontend\src\hooks\useWindowResize.jsx", "JavaScript JSX", 18, 0, 0, 0, 0, 6, 24
"c:\Users\bazc\Desktop\coding\frontend-mentors\invoice-app\frontend\src\main.jsx", "JavaScript JSX", 16, 0, 0, 0, 0, 6, 22
"c:\Users\bazc\Desktop\coding\frontend-mentors\invoice-app\frontend\src\pages\EditInvoice\EditInvoice.jsx", "JavaScript JSX", 41, 0, 0, 0, 3, 14, 58
"c:\Users\bazc\Desktop\coding\frontend-mentors\invoice-app\frontend\src\pages\EditInvoice\EditInvoiceForm.jsx", "JavaScript JSX", 204, 0, 0, 0, 15, 26, 245
"c:\Users\bazc\Desktop\coding\frontend-mentors\invoice-app\frontend\src\pages\EditInvoice\index.js", "JavaScript", 0, 0, 1, 0, 0, 1, 2
"c:\Users\bazc\Desktop\coding\frontend-mentors\invoice-app\frontend\src\pages\Home\Home.jsx", "JavaScript JSX", 11, 0, 0, 0, 0, 4, 15
"c:\Users\bazc\Desktop\coding\frontend-mentors\invoice-app\frontend\src\pages\Home\index.js", "JavaScript", 0, 0, 1, 0, 0, 1, 2
"c:\Users\bazc\Desktop\coding\frontend-mentors\invoice-app\frontend\src\pages\Invoice\Invoice.jsx", "JavaScript JSX", 132, 0, 0, 0, 16, 28, 176
"c:\Users\bazc\Desktop\coding\frontend-mentors\invoice-app\frontend\src\pages\Invoice\InvoiceItem.jsx", "JavaScript JSX", 29, 0, 0, 0, 0, 4, 33
"c:\Users\bazc\Desktop\coding\frontend-mentors\invoice-app\frontend\src\pages\Invoice\ItemsSection.jsx", "JavaScript JSX", 68, 0, 0, 0, 5, 7, 80
"c:\Users\bazc\Desktop\coding\frontend-mentors\invoice-app\frontend\src\pages\Invoice\index.js", "JavaScript", 0, 0, 1, 0, 0, 1, 2
"c:\Users\bazc\Desktop\coding\frontend-mentors\invoice-app\frontend\src\pages\Invoices\InvoicePreview.jsx", "JavaScript JSX", 72, 0, 0, 0, 3, 17, 92
"c:\Users\bazc\Desktop\coding\frontend-mentors\invoice-app\frontend\src\pages\Invoices\Invoices.jsx", "JavaScript JSX", 60, 0, 0, 0, 5, 16, 81
"c:\Users\bazc\Desktop\coding\frontend-mentors\invoice-app\frontend\src\pages\Invoices\index.js", "JavaScript", 0, 0, 1, 0, 0, 1, 2
"c:\Users\bazc\Desktop\coding\frontend-mentors\invoice-app\frontend\src\pages\Login\Login.jsx", "JavaScript JSX", 87, 0, 0, 0, 2, 12, 101
"c:\Users\bazc\Desktop\coding\frontend-mentors\invoice-app\frontend\src\pages\Login\LoginModal.jsx", "JavaScript JSX", 88, 0, 0, 0, 2, 14, 104
"c:\Users\bazc\Desktop\coding\frontend-mentors\invoice-app\frontend\src\pages\Login\index.js", "JavaScript", 0, 0, 1, 0, 0, 1, 2
"c:\Users\bazc\Desktop\coding\frontend-mentors\invoice-app\frontend\src\pages\NewInvoice\NewInvoice.jsx", "JavaScript JSX", 52, 0, 0, 0, 6, 19, 77
"c:\Users\bazc\Desktop\coding\frontend-mentors\invoice-app\frontend\src\pages\NewInvoice\NewInvoiceForm.jsx", "JavaScript JSX", 209, 0, 0, 0, 10, 23, 242
"c:\Users\bazc\Desktop\coding\frontend-mentors\invoice-app\frontend\src\pages\NewInvoice\index.js", "JavaScript", 0, 0, 1, 0, 0, 1, 2
"c:\Users\bazc\Desktop\coding\frontend-mentors\invoice-app\frontend\src\pages\NotFoundPage\NotFoundPage.jsx", "JavaScript JSX", 16, 0, 0, 0, 0, 5, 21
"c:\Users\bazc\Desktop\coding\frontend-mentors\invoice-app\frontend\src\pages\NotFoundPage\index.js", "JavaScript", 0, 0, 1, 0, 0, 1, 2
"c:\Users\bazc\Desktop\coding\frontend-mentors\invoice-app\frontend\src\pages\PageLayout\PageLayout.jsx", "JavaScript JSX", 48, 0, 0, 0, 1, 7, 56
"c:\Users\bazc\Desktop\coding\frontend-mentors\invoice-app\frontend\src\pages\PageLayout\index.js", "JavaScript", 0, 0, 1, 0, 0, 1, 2
"c:\Users\bazc\Desktop\coding\frontend-mentors\invoice-app\frontend\src\pages\Signup.jsx\Signup.jsx", "JavaScript JSX", 264, 0, 0, 0, 12, 35, 311
"c:\Users\bazc\Desktop\coding\frontend-mentors\invoice-app\frontend\src\pages\Signup.jsx\index.js", "JavaScript", 0, 0, 1, 0, 0, 1, 2
"c:\Users\bazc\Desktop\coding\frontend-mentors\invoice-app\frontend\src\pages\UserProfile\UserProfile.jsx", "JavaScript JSX", 31, 0, 0, 0, 1, 12, 44
"c:\Users\bazc\Desktop\coding\frontend-mentors\invoice-app\frontend\src\pages\UserProfile\UserProfileForm.jsx", "JavaScript JSX", 108, 0, 0, 0, 7, 11, 126
"c:\Users\bazc\Desktop\coding\frontend-mentors\invoice-app\frontend\src\pages\UserProfile\index.js", "JavaScript", 0, 0, 1, 0, 0, 1, 2
"c:\Users\bazc\Desktop\coding\frontend-mentors\invoice-app\frontend\src\styles\index.css", "CSS", 0, 112, 0, 0, 0, 18, 130
"Total", "-", 2823, 112, 10, 219, 170, 604, 3938